1111111111111
1P0100000CE11
11000C1111111
1000100000001
1111111111111