1111111111111111111111111
1GC10C00000C11100C00G11C1
10000G1111011000010G11101
1P0011E0C0000011000000001
1111111111111111111111111
