1111111111111
10010000000C1
1000001111101
1P0011E0000C1
1111111111111