1111111111111
100100C0C0001
10GC011111001
100011000C001
1101P10000G11
1G0100E0C00C1
10C0100110C01
1000110C00101
11G0G01100111
1C000CCC10CC1
1111111111111
