1111111111111
100100C000001
1000011111001
10P0110000001
110000CC00011
10010000000C1
10C0100110C01
10001100001E1
1100000110011
1000110000101
1100000110011
1111111111111